// paths for each block in UP-DOWN-LEFT-RIGHT binary format
// example: 03 = 0b0011 -> we can go to the left and to the right
// example: 00 = 0b0000 -> the path is blocked from all sides
// example: 15 = 0b1111 -> we can go up, down, left, right
05	03	03	07	03	03	03	06	00	04	00	00	05	03	06	00	05	03	06	
12	00	00	12	00	00	00	12	00	09	03	07	10	00	09	03	14	00	12	
12	00	05	11	03	06	00	12	00	00	00	12	00	00	00	00	12	00	12	
12	00	12	00	00	12	00	13	03	03	03	15	03	02	00	05	10	00	12	
12	00	12	00	05	11	03	14	00	04	00	12	00	04	00	12	00	00	12	
09	03	15	03	14	00	00	12	00	04	00	12	00	12	00	12	00	05	10	
00	00	12	00	13	03	00	13	03	11	03	14	00	12	00	09	03	10	00	
00	00	12	00	12	00	00	12	00	00	00	13	03	14	00	00	00	00	00	
05	03	11	07	11	06	00	13	03	07	03	14	00	09	03	07	03	03	06	
12	00	00	12	00	12	00	12	00	12	00	12	00	00	00	12	00	00	12	
09	03	03	11	03	11	03	10	00	09	03	11	03	03	03	11	03	03	10	

// special functions (see States.h for more info)
// example: 4 is for power-pellet, 1 for tunnel
4 0 0 0 0 0 0 0 0 0 0 0 0 0 0 0 0 0 4 
0 0 0 0 0 0 0 0 0 0 0 0 0 0 0 0 0 0 0 
0 0 0 0 0 0 0 0 0 0 0 2 0 0 0 0 0 0 0 
0 0 0 0 0 0 0 0 0 0 0 0 0 0 0 0 0 0 0 
0 0 0 0 0 0 0 0 0 6 0 0 0 1 0 0 0 0 0 
0 0 0 0 0 0 0 0 0 3 0 0 0 0 0 0 0 0 0 
0 0 0 0 0 0 1 0 0 0 0 0 0 0 0 0 0 0 0 
0 0 0 0 0 0 0 0 0 0 0 0 0 0 0 0 0 0 0 
0 0 0 0 0 0 0 0 0 0 0 0 0 0 0 0 0 0 0 
0 0 0 0 0 0 0 0 0 5 0 0 0 0 0 0 0 0 0 
4 0 0 0 0 0 0 0 0 0 0 0 0 0 0 0 0 0 4 
